#####B#
#   # #

# ### #
#   # #

##  ###
##    #
     ##
A######